# type: overworld
# warp: 5,11 -> 106,13
# warp: 6,11 -> 106,13
# warp: 124,11 -> 8,13
# warp: 125,11 -> 8,13
................................................................................................................................
........................................................................................................XXXXXXXXXXXXXXXXXXXXXXXX
........................................................................................................X......................X
........................................................................................................X......................X
........................................................................................................X..CCCCCCCCCCCCCCCC....X
........................................................................................................X......................X
....................................................Y...................................................X..CCCCCCCCCCCCCCCC....X
........................................................................................................X...............K......X
..................................................................................F.....................X.........=====........X
........................B?MB...G................................CCCC....................................X......................X
..............................====..............................====....................................X......................X
.....TT.................................................................................................X..CCCCCCCCCCCCCCCC.TT.X
..P..tt.CCCCK.G.......................G.....................G.....................K.....................X.....G.............tt.X
XXXXXXXXXXXXXXXXXXXX...XXXXXXXXXXXXXXXXXXXXXX...XXXXXXXXXXXXXXXXXXXXXXXXXXXXXXXXXXXXXXXX................XXXXXXXXXXXXXXXXXXXXXXXX
XXXXXXXXXXXXXXXXXXXX...XXXXXXXXXXXXXXXXXXXXXX...XXXXXXXXXXXXXXXXXXXXXXXXXXXXXXXXXXXXXXXX................XXXXXXXXXXXXXXXXXXXXXXXX
