# type: keep
........................................................................................
........................................................................................
........................................................................................
........................................................................................
........................................................................................
........................................................................................
........................................................................................
........................................................................................
....................................................................................F...
........M...............................M...............................................
..................................====..............====................................
........................N.........................N...............N.....................
..P.........K...........N.............K...........N...............N.............K.......
XXXXXXXXXXXXXXXXLLXXXXXXXXXX...XXXXXXXXXXXXXLLXXXXXXXXXXXX..XXXXXXXXXXXXLLXXXXXXXXXXXXXX
XXXXXXXXXXXXXXXXLLXXXXXXXXXX...XXXXXXXXXXXXXLLXXXXXXXXXXXX..XXXXXXXXXXXXLLXXXXXXXXXXXXXX
