# type: water
# warp: 5,11 -> 92,13
# warp: 6,11 -> 92,13
# warp: 104,11 -> 8,13
# warp: 105,11 -> 8,13
XXXXXXXXXXXXXXXXXXXXXXXXXXXXXXXXXXXXXXXXXXXXXXXXXXXXXXXXXXXXXXXXXXXXXXXXXXXXXXXXXXXXXXXX....................
............................................................................................................
............................................................................................................
............................................................................................................
....................H...............................................H.......................................
............................................................................................................
....................................................................................F.......................
..........................................................................................XXXXXXXXXXXXXXXXXX
......................................CCCCC...............................................X................X
..........................................................................................X................X
..............................X.............H...........X.................................X..CCCCCCCCCC....X
..P..TT.......................X.........................X.................................X..CCCCCCCCCC.TT.X
.....tt.......................X.........................X.................................X..CCCCCCCCCC.tt.X
XXXXXXXXXXXXXXXXXXXXXXXXXXXXXXXXXXXXXXXXXXXXXXXXXXXXXXXXXXXXXXXXXXXXXXXXXXXXXXXXXXXXXXXX..XXXXXXXXXXXXXXXXXX
XXXXXXXXXXXXXXXXXXXXXXXXXXXXXXXXXXXXXXXXXXXXXXXXXXXXXXXXXXXXXXXXXXXXXXXXXXXXXXXXXXXXXXXX..XXXXXXXXXXXXXXXXXX
