# type: overworld
# warp: 72,11 -> 106,13
# warp: 73,11 -> 106,13
# warp: 124,11 -> 75,13
# warp: 125,11 -> 75,13
................................................................................................................................
........................................................................................................XXXXXXXXXXXXXXXXXXXXXXXX
........................................................................................................X......................X
........................................................................................................X......................X
........................................................................................................X..CCCCCCCCCCCCCCCC....X
........................................................................................................X......................X
........................................................................................................X..CCCCCCCCCCCCCCCC....X
........................................Y.............................Y.................................X...............K......X
..................................................................................F.....................X.........=====........X
....................?....G..................CCCC.................G......................................X......................X
........................====................====................====....................................X......................X
........................................................................TT..............................X..CCCCCCCCCCCCCCCC.TT.X
..P....KCCCCG...................................G.......................tt........K.....................X.....G.............tt.X
XXXXXXXXXXXXXXXX...XXXXXXXXXXXXXX...XXXXXXXXXXXXXXXXXXX...XXXXXXXXXXXXXXXXXXXXXXXXXXXXXX................XXXXXXXXXXXXXXXXXXXXXXXX
XXXXXXXXXXXXXXXX...XXXXXXXXXXXXXX...XXXXXXXXXXXXXXXXXXX...XXXXXXXXXXXXXXXXXXXXXXXXXXXXXX................XXXXXXXXXXXXXXXXXXXXXXXX
