# type: castle
........................................................................................
XXXXXXXXXXXXXXXXXXXXXXXXXXXXXXXXXXXXXXXXXXXXXXXXXXXXXXXXXXXXXXXXXXXXXXXXXXXXXXXXXXXXXXXX
......................................................................................XX
......................................................................................XX
......................................................................................XX
......................................................................................XX
......................................................................................XX
......................................................................................XX
......................................................................................XX
......................................................................................XX
........................M...M...................M.......M.......M.....................XX
......................................................................................XX
..P.....................................................................Z.............XX
XXXXXXXXXXXXXXXXXLLXXXXXXXXXXXXXXXXXXXXXLLXXXXXXXXXXXXXXXXXXXXXXXXXXXXXXXXXXXXXXXXXXXXXX
XXXXXXXXXXXXXXXXXLLXXXXXXXXXXXXXXXXXXXXXLLXXXXXXXXXXXXXXXXXXXXXXXXXXXXXXXXXXXXXXXXXXXXXX
