# type: sky
# warp: 74,11 -> 106,13
# warp: 75,11 -> 106,13
# warp: 124,11 -> 77,13
# warp: 125,11 -> 77,13
................................................................................................................................
........................................................................................................XXXXXXXXXXXXXXXXXXXXXXXX
........................................................................................................X......................X
........................................................................................................X......................X
........................................................................................................X..CCCCCCCCCCCCCCCC....X
........................................................................................................X......................X
........................................................................................................X..CCCCCCCCCCCCCCCC....X
........................................................................................................X...............Y......X
....................................................................................F...................X.........=====........X
..........................M.............................................................................X......................X
..............................====....................====..............................................X......................X
......................................N.....................N.............TT............................X..CCCCCCCCCCCCCCCC.TT.X
..P...........G.......................N...........K.........N...........G.tt............................X.....Y.............tt.X
XXXXXXXXXXXXXXXXXXXX...XXXXXXXXXXXXXXXXXXXXX..XXXXXXXXXXXXXXXXXXXX...XXXXXXXXXXXXXXXXXXX................XXXXXXXXXXXXXXXXXXXXXXXX
XXXXXXXXXXXXXXXXXXXX...XXXXXXXXXXXXXXXXXXXXX..XXXXXXXXXXXXXXXXXXXX...XXXXXXXXXXXXXXXXXXX................XXXXXXXXXXXXXXXXXXXXXXXX
