# type: water
# warp: 5,11 -> 106,13
# warp: 6,11 -> 106,13
# warp: 124,11 -> 8,13
# warp: 125,11 -> 8,13
XXXXXXXXXXXXXXXXXXXXXXXXXXXXXXXXXXXXXXXXXXXXXXXXXXXXXXXXXXXXXXXXXXXXXXXXXXXXXXXXXXXXXXXX........................................
........................................................................................................XXXXXXXXXXXXXXXXXXXXXXXX
........................................................................................................X......................X
........................................................................................................X......................X
....................H...............................................H...................................X..CCCCCCCCCCCCCCCC....X
........................................................................................................X......................X
....................................................................................F...................X..CCCCCCCCCCCCCCCC....X
........................................................................................................X...............H......X
......................................CCCCC.............................................................X.........=====........X
........................................................................................................X......................X
..............................X.............H...........X...............................................X......................X
..P..TT.......................X.........................X...............................................X..CCCCCCCCCCCCCCCC.TT.X
.....tt.......................X.........................X...............................................X.....H.............tt.X
XXXXXXXXXXXXXXXXXXXXXXXXXXXXXXXXXXXXXXXXXXXXXXXXXXXXXXXXXXXXXXXXXXXXXXXXXXXXXXXXXXXXXXXX................XXXXXXXXXXXXXXXXXXXXXXXX
XXXXXXXXXXXXXXXXXXXXXXXXXXXXXXXXXXXXXXXXXXXXXXXXXXXXXXXXXXXXXXXXXXXXXXXXXXXXXXXXXXXXXXXX................XXXXXXXXXXXXXXXXXXXXXXXX
