# type: overworld
........................................................................................
........................................................................................
........................................................................................
........................................................................................
........................................................................................
........................................................................................
..................................................Y.....................................
........................................................................................
..................................................................................F.....
..........................B?MB..........................................................
........................................................................................
........................................................................................
..P.....CCCC......................G.........................G...........................
XXXXXXXXXXXXXXXXXXXX...XXXXXXXXXXXXXXXXXXXXXX...XXXXXXXXXXXXXXXXXXXXXXXXXXXXXXXXXXXXXXXX
XXXXXXXXXXXXXXXXXXXX...XXXXXXXXXXXXXXXXXXXXXX...XXXXXXXXXXXXXXXXXXXXXXXXXXXXXXXXXXXXXXXX
