# type: keep
........................................................................................
........................................................................................
........................................................................................
........................................................................................
........................................................................................
........................................................................................
........................................................................................
........................................................................................
....................................................................................F...
........M.............................M.................................................
........................................................................................
...................N....................N.....................N.........................
..P.........K......N....................N...........K.........N.........K...............
XXXXXXXXXXXXXXLLXXXXXX...XXXXXXXXXLLXXXXXXXXXX..XXXXXXXXLLXXXXXXXX...XXXXXXXXXXXXXXXXXXX
XXXXXXXXXXXXXXLLXXXXXX...XXXXXXXXXLLXXXXXXXXXX..XXXXXXXXLLXXXXXXXX...XXXXXXXXXXXXXXXXXXX
