# type: haunted
# warp: 74,11 -> 92,13
# warp: 75,11 -> 92,13
# warp: 104,11 -> 77,13
# warp: 105,11 -> 77,13
............................................................................................................
............................................................................................................
............................................................................................................
............................................................................................................
............................................................................................................
............................................................................................................
............................................................................................................
..................O.........................O.............................................XXXXXXXXXXXXXXXXXX
....................................................................................F.....X................X
..........M.........................M.....................................................X................X
..............................====........................====............................X..CCCCCCCCCC....X
..........................................................................TT..............X..CCCCCCCCCC.TT.X
..P.............................................................G.........tt..............X..CCCCCCCCCC.tt.X
XXXXXXXXXXXXXXXXXXXXXXXX..XXXXXXXXXXXXXXXXXXXXXXXX...XXXXXXXXXXXXXXXXX..XXXXXXXXXXXXXXXX..XXXXXXXXXXXXXXXXXX
XXXXXXXXXXXXXXXXXXXXXXXX..XXXXXXXXXXXXXXXXXXXXXXXX...XXXXXXXXXXXXXXXXX..XXXXXXXXXXXXXXXX..XXXXXXXXXXXXXXXXXX
