# type: caldera
........................................................................................
........................................................................................
........................................................................................
........................................................................................
........................................................................................
........................................................................................
..................................................................................F.....
..............................................................................=======...
.............................=====.........=====.........=====.........=====............
......................=====.........=====.........=====.........=====...................
...............=====....................................................................
........=====...........................................................................
XXPXXX..................................................................................
XXXXXX..................................................................................
XXXXXX..................................................................................
