# type: factory
# warp: 75,11 -> 106,13
# warp: 76,11 -> 106,13
# warp: 124,11 -> 78,13
# warp: 125,11 -> 78,13
................................................................................................................................
........................................................................................................XXXXXXXXXXXXXXXXXXXXXXXX
........................................................................................................X......................X
........................................................................................................X......................X
........................................................................................................X..CCCCCCCCCCCCCCCC....X
........................................................................................................X......................X
........................................................................................................X..CCCCCCCCCCCCCCCC....X
........................................................................................................X...............R......X
....................................................................................F...................X.........=====........X
......M.................................M...............................................................X......................X
................................===...............===...................................................X......................X
...........................................................................TT...........................X..CCCCCCCCCCCCCCCC.TT.X
..P...................R.......K...............R...................R........tt...........................X.....R.............tt.X
XXXXXXXX>>>>>>>XXX..XXXX<<<<<<<XXXXX...XXX>>>>>>>XXXXX..XX<<<<<<<XXXXX..XXXXXXXXXXXXXXXX................XXXXXXXXXXXXXXXXXXXXXXXX
XXXXXXXXXXXXXXXXXX..XXXXXXXXXXXXXXXX...XXXXXXXXXXXXXXX..XXXXXXXXXXXXXX..XXXXXXXXXXXXXXXX................XXXXXXXXXXXXXXXXXXXXXXXX
