# type: factory
........................................................................................
........................................................................................
........................................................................................
........................................................................................
........................................................................................
........................................................................................
........................................................................................
........................................................................................
....................................................................................F...
......M.............................M...........................M.......................
..........................===...........===.............................................
........................................................................................
..P.....................R.............R.............R.............R.............G.......
XXXXXXXX>>>>>>XX..XX<<<<<<XXXX...X>>>>>>XXXX..XX<<<<<<XXXX..XX>>>>>>XXXXXX..XXXXXXXXXXXX
XXXXXXXXXXXXXXXX..XXXXXXXXXXXX...XXXXXXXXXXX..XXXXXXXXXXXX..XXXXXXXXXXXXXX..XXXXXXXXXXXX
