# type: caldera
# warp: 4,10 -> 106,12
# warp: 5,10 -> 106,12
# warp: 124,10 -> 7,12
# warp: 125,10 -> 7,12
................................................................................................................................
........................................................................................................XXXXXXXXXXXXXXXXXXXXXXXX
........................................................................................................X......................X
........................................................................................................X..CCCCCCCCCCCCCCCC....X
........................................................................................................X......................X
........................................................................................................X..CCCCCCCCCCCCCCCC....X
..................................................................................F.....................X...............K......X
..............................................................................=======...................X.........=====........X
....................................=====.........=====.........=====..=====............................X......................X
......................=====..=====.........=====.........=====..........................................X......................X
....TT.........=====....................................................................................X..CCCCCCCCCCCCCCCC.TT.X
..P.tt..=====...........................................................................................X.....K.............tt.X
XXXXXXXX................................................................................................XXXXXXXXXXXXXXXXXXXXXXXX
XXXXXXXX................................................................................................XXXXXXXXXXXXXXXXXXXXXXXX
XXXXXXXX........................................................................................................................
