# type: keep
........................................................................................
........................................................................................
........................................................................................
........................................................................................
........................................................................................
........................................................................................
........................................................................................
........................................................................................
....................................................................................F...
........M...........................M...................................................
........................====....................................====....................
..............................N.....................N...................................
..P...........K...............N.................K...N.................K.................
XXXXXXXXXXXXXXXXXXXXLLXXXXXXXXXXXXXXXXXX...XXXXXXXXXXXXXXXXXLLXXXXXXXXXXXXXXXXXXXXXXXXXX
XXXXXXXXXXXXXXXXXXXXLLXXXXXXXXXXXXXXXXXX...XXXXXXXXXXXXXXXXXLLXXXXXXXXXXXXXXXXXXXXXXXXXX
