# type: factory
........................................................................................
........................................................................................
........................................................................................
........................................................................................
........................................................................................
........................................................................................
........................................................................................
........................................................................................
....................................................................................F...
......M.................................M...............................................
................................===...............===...................................
........................................................................................
..P...................R.......K...............R...................R.....................
XXXXXXXX>>>>>>>XXX..XXXX<<<<<<<XXXXX...XXX>>>>>>>XXXXX..XX<<<<<<<XXXXX..XXXXXXXXXXXXXXXX
XXXXXXXXXXXXXXXXXX..XXXXXXXXXXXXXXXX...XXXXXXXXXXXXXXX..XXXXXXXXXXXXXX..XXXXXXXXXXXXXXXX
