# type: factory
........................................................................................
........................................................................................
........................................................................................
........................................................................................
........................................................................................
........................................................................................
........................................................................................
........................................................................................
....................................................................................F...
........M...............................M...............................................
..................===.........................===.......................................
........................................................................................
..P.......................R.................................R...........G...............
XXXXXXXXXX>>>>>>>XXXXX..XXXXXX<<<<<<<XXXXXXX..XXXX>>>>>>>XXXXXXX...XXXXXXXXXXXXXXXXXXXXX
XXXXXXXXXXXXXXXXXXXXXX..XXXXXXXXXXXXXXXXXXXX..XXXXXXXXXXXXXXXXXX...XXXXXXXXXXXXXXXXXXXXX
