# type: castle
........................................................................................
XXXXXXXXXXXXXXXXXXXXXXXXXXXXXXXXXXXXXXXXXXXXXXXXXXXXXXXXXXXXXXXXXXXXXXXXXXXXXXXXXXXXXXXX
......................................................................................XX
......................................................................................XX
......................................................................................XX
......................................................................................XX
......................................................................................XX
......................................................................................XX
......................................................................................XX
......................................................................................XX
........................M...M.........................................................XX
................................................................................N.....XX
..P.....................................................................Z.......N.....XX
XXXXXXXXXXXXXXXXXLLXXXXXXXXXXXXXXXXXXXXXLLXXXXXXXXXXXXXXXXXXXXXXXXXXXXXXXXXXXXXXXXXXXXXX
XXXXXXXXXXXXXXXXXLLXXXXXXXXXXXXXXXXXXXXXLLXXXXXXXXXXXXXXXXXXXXXXXXXXXXXXXXXXXXXXXXXXXXXX
