# type: keep
# warp: 75,11 -> 92,13
# warp: 76,11 -> 92,13
# warp: 104,11 -> 78,13
# warp: 105,11 -> 78,13
............................................................................................................
............................................................................................................
............................................................................................................
............................................................................................................
............................................................................................................
............................................................................................................
............................................................................................................
..........................................................................................XXXXXXXXXXXXXXXXXX
....................................................................................F.....X................X
........M.............................M...................................................X................X
..........................................................................................X..CCCCCCCCCC....X
...................N....................N.....................N............TT.............X..CCCCCCCCCC.TT.X
..P.........K......N....................N...........K.........N.........K..tt.............X..CCCCCCCCCC.tt.X
XXXXXXXXXXXXXXLLXXXXXX...XXXXXXXXXLLXXXXXXXXXX..XXXXXXXXLLXXXXXXXX...XXXXXXXXXXXXXXXXXXX..XXXXXXXXXXXXXXXXXX
XXXXXXXXXXXXXXLLXXXXXX...XXXXXXXXXLLXXXXXXXXXX..XXXXXXXXLLXXXXXXXX...XXXXXXXXXXXXXXXXXXX..XXXXXXXXXXXXXXXXXX
