# type: factory
# warp: 75,11 -> 92,13
# warp: 76,11 -> 92,13
# warp: 104,11 -> 78,13
# warp: 105,11 -> 78,13
............................................................................................................
............................................................................................................
............................................................................................................
............................................................................................................
............................................................................................................
............................................................................................................
............................................................................................................
..........................................................................................XXXXXXXXXXXXXXXXXX
....................................................................................F.....X................X
......M.................................M.................................................X................X
................................===...............===.....................................X..CCCCCCCCCC....X
...........................................................................TT.............X..CCCCCCCCCC.TT.X
..P...................R.......K...............R...................R........tt.............X..CCCCCCCCCC.tt.X
XXXXXXXX>>>>>>>XXX..XXXX<<<<<<<XXXXX...XXX>>>>>>>XXXXX..XX<<<<<<<XXXXX..XXXXXXXXXXXXXXXX..XXXXXXXXXXXXXXXXXX
XXXXXXXXXXXXXXXXXX..XXXXXXXXXXXXXXXX...XXXXXXXXXXXXXXX..XXXXXXXXXXXXXX..XXXXXXXXXXXXXXXX..XXXXXXXXXXXXXXXXXX
