# type: water
XXXXXXXXXXXXXXXXXXXXXXXXXXXXXXXXXXXXXXXXXXXXXXXXXXXXXXXXXXXXXXXXXXXXXXXXXXXXXXXXXXXXXXXX
........................................................................................
........................................................................................
........................................................................................
..............H.......................H.......................................H.........
........................................................................................
....................................................................................F...
........................X...............................X...............................
........................X...............................X...............................
........................X...............................X...............................
........................X...............X.......H.......X.......H.......X...............
..P.....................X...............X...............X...............X...............
........................X...............X...............X...............X...............
XXXXXXXXXXXXXXXXXXXXXXXXXXXXXXXXXXXXXXXXXXXXXXXXXXXXXXXXXXXXXXXXXXXXXXXXXXXXXXXXXXXXXXXX
XXXXXXXXXXXXXXXXXXXXXXXXXXXXXXXXXXXXXXXXXXXXXXXXXXXXXXXXXXXXXXXXXXXXXXXXXXXXXXXXXXXXXXXX
