# type: overworld
........................................................................................
........................................................................................
........................................................................................
........................................................................................
........................................................................................
........................................................................................
....................................................Y...................................
........................................................................................
..................................................................................F.....
........................B?MB...G................................CCCC....................
..............................====..............................====....................
........................................................................................
..P.....CCCCK.G.......................G.....................G.....................K.....
XXXXXXXXXXXXXXXXXXXX...XXXXXXXXXXXXXXXXXXXXXX...XXXXXXXXXXXXXXXXXXXXXXXXXXXXXXXXXXXXXXXX
XXXXXXXXXXXXXXXXXXXX...XXXXXXXXXXXXXXXXXXXXXX...XXXXXXXXXXXXXXXXXXXXXXXXXXXXXXXXXXXXXXXX
