# type: haunted
# warp: 74,11 -> 92,13
# warp: 75,11 -> 92,13
# warp: 104,11 -> 77,13
# warp: 105,11 -> 77,13
............................................................................................................
............................................................................................................
............................................................................................................
............................................................................................................
............................................................................................................
............................................................................................................
........................................O...................................................................
................O.........................................................................XXXXXXXXXXXXXXXXXX
............................................................O.......................F.....X................X
........M.......................M.........................................................X................X
..........................====..............====............===...........................X..CCCCCCCCCC....X
..........................................................................TT..............X..CCCCCCCCCC.TT.X
..P...............................................K.......................tt..............X..CCCCCCCCCC.tt.X
XXXXXXXXXXXXXXXXXXXX..XXXXXXXXXXXXXX...XXXXXXXXXXXXXXX..XXXXXXXXXXXX...XXXXXXXXXXXXXXXXX..XXXXXXXXXXXXXXXXXX
XXXXXXXXXXXXXXXXXXXX..XXXXXXXXXXXXXX...XXXXXXXXXXXXXXX..XXXXXXXXXXXX...XXXXXXXXXXXXXXXXX..XXXXXXXXXXXXXXXXXX
