# type: sky
........................................................................................
........................................................................................
........................................................................................
........................................................................................
........................................................................................
........................................................................................
........................................................................................
........................................................................................
....................................................................................F...
..........................M.............................................................
..............................====....................====..............................
......................................N.....................N...........................
..P...........G.......................N...........K.........N...........G...............
XXXXXXXXXXXXXXXXXXXX...XXXXXXXXXXXXXXXXXXXXX..XXXXXXXXXXXXXXXXXXXX...XXXXXXXXXXXXXXXXXXX
XXXXXXXXXXXXXXXXXXXX...XXXXXXXXXXXXXXXXXXXXX..XXXXXXXXXXXXXXXXXXXX...XXXXXXXXXXXXXXXXXXX
