# type: keep
# warp: 4,11 -> 106,13
# warp: 5,11 -> 106,13
# warp: 124,11 -> 7,13
# warp: 125,11 -> 7,13
................................................................................................................................
........................................................................................................XXXXXXXXXXXXXXXXXXXXXXXX
........................................................................................................X......................X
........................................................................................................X......................X
........................................................................................................X..CCCCCCCCCCCCCCCC....X
........................................................................................................X......................X
........................................................................................................X..CCCCCCCCCCCCCCCC....X
........................................................................................................X...............K......X
....................................................................................F...................X.........=====........X
........M...........................M...................................................................X......................X
........................====....................................====....................................X......................X
....TT........................N.....................N...................................................X..CCCCCCCCCCCCCCCC.TT.X
..P.tt........K...............N.................K...N.................K.................................X.....K.............tt.X
XXXXXXXXXXXXXXXXXXXXLLXXXXXXXXXXXXXXXXXX...XXXXXXXXXXXXXXXXXLLXXXXXXXXXXXXXXXXXXXXXXXXXX................XXXXXXXXXXXXXXXXXXXXXXXX
XXXXXXXXXXXXXXXXXXXXLLXXXXXXXXXXXXXXXXXX...XXXXXXXXXXXXXXXXXLLXXXXXXXXXXXXXXXXXXXXXXXXXX................XXXXXXXXXXXXXXXXXXXXXXXX
