........................................................................................
........................................................................................
........................................................................................
........................................................................................
........................................................................................
........................................................................................
........................................................................................
........................................................................................
..................................................................................F.....
......................B??B.....CCCCC..................CCCCC.............................
...............................=====..................=====.............................
........................................................................................
..P.....CCCCC...............G.....................G...........................G.........
XXXXXXXXXXXXXXXXX...XXXXXXXXXXXXXXXXX...XXXXXXXXXXXXXXXXXXXXXX...XXXXXXXXXXXXXXXXXXXXXXX
XXXXXXXXXXXXXXXXX...XXXXXXXXXXXXXXXXX...XXXXXXXXXXXXXXXXXXXXXX...XXXXXXXXXXXXXXXXXXXXXXX
