# type: castle
........................................................................................
XXXXXXXXXXXXXXXXXXXXXXXXXXXXXXXXXXXXXXXXXXXXXXXXXXXXXXXXXXXXXXXXXXXXXXXXXXXXXXXXXXXXXXXX
......................................................................................XX
......................................................................................XX
......................................................................................XX
......................................................................................XX
......................................................................................XX
......................................................................................XX
......................................................................................XX
......................................................................................XX
........................M...M.........................................................XX
......................................................................................XX
..P.....................................................................Z.............XX
XXXXXXXXXXXXXXXXXLLXXXXXXXXXXXXXXXXXXXXXLLXXXXXXXXXXXXXXXXXXXXXXXXXXXXXXXXXXXXXXXXXXXXXX
XXXXXXXXXXXXXXXXXLLXXXXXXXXXXXXXXXXXXXXXLLXXXXXXXXXXXXXXXXXXXXXXXXXXXXXXXXXXXXXXXXXXXXXX
