# type: ice
# warp: 74,11 -> 106,13
# warp: 75,11 -> 106,13
# warp: 124,11 -> 77,13
# warp: 125,11 -> 77,13
................................................................................................................................
........................................................................................................XXXXXXXXXXXXXXXXXXXXXXXX
........................................................................................................X......................X
........................................................................................................X......................X
........................................................................................................X..CCCCCCCCCCCCCCCC....X
........................................................................................................X......................X
........................................................................................................X..CCCCCCCCCCCCCCCC....X
........................................................................................................X...............I......X
....................................................................................F...................X.........=====........X
........M.......................M.......................................................................X......................X
..........................====..............====............===.........................................X......................X
..........................................................................TT............................X..CCCCCCCCCCCCCCCC.TT.X
..P...........I...........K.....................I...............I.........tt............................X.....I.............tt.X
XXXXXXXXXXXXXXXXXXXX..XXXXXXXXXXXXXX...XXXXXXXXXXXXXXX..XXXXXXXXXXXX...XXXXXXXXXXXXXXXXX................XXXXXXXXXXXXXXXXXXXXXXXX
XXXXXXXXXXXXXXXXXXXX..XXXXXXXXXXXXXX...XXXXXXXXXXXXXXX..XXXXXXXXXXXX...XXXXXXXXXXXXXXXXX................XXXXXXXXXXXXXXXXXXXXXXXX
