# type: overworld
........................................................................................
........................................................................................
........................................................................................
........................................................................................
........................................................................................
........................................................................................
..........................................Y.............................................
........................................................................................
....................................................................................F...
......................B?MB....G...............CCCCC.....................................
............................=====.............=====.....................................
........................................................................................
..P....KCCCCG.......................................G.............G...............K.....
XXXXXXXXXXXXXXXXX...XXXXXXXXXXXXXXXXX...XXXXXXXXXXXXXXXXXX...XXXXXXXXXXX...XXXXXXXXXXXXX
XXXXXXXXXXXXXXXXX...XXXXXXXXXXXXXXXXX...XXXXXXXXXXXXXXXXXX...XXXXXXXXXXX...XXXXXXXXXXXXX
