# type: haunted
# warp: 74,11 -> 106,13
# warp: 75,11 -> 106,13
# warp: 124,11 -> 77,13
# warp: 125,11 -> 77,13
................................................................................................................................
........................................................................................................XXXXXXXXXXXXXXXXXXXXXXXX
........................................................................................................X......................X
........................................................................................................X......................X
........................................................................................................X..CCCCCCCCCCCCCCCC....X
........................................................................................................X......................X
........................................O...............................................................X..CCCCCCCCCCCCCCCC....X
................O.......................................................................................X...............O......X
............................................................O.......................F...................X.........=====........X
........M.......................M.......................................................................X......................X
..........................====..............====............===.........................................X......................X
..........................................................................TT............................X..CCCCCCCCCCCCCCCC.TT.X
..P...............................................K.......................tt............................X.....O.............tt.X
XXXXXXXXXXXXXXXXXXXX..XXXXXXXXXXXXXX...XXXXXXXXXXXXXXX..XXXXXXXXXXXX...XXXXXXXXXXXXXXXXX................XXXXXXXXXXXXXXXXXXXXXXXX
XXXXXXXXXXXXXXXXXXXX..XXXXXXXXXXXXXX...XXXXXXXXXXXXXXX..XXXXXXXXXXXX...XXXXXXXXXXXXXXXXX................XXXXXXXXXXXXXXXXXXXXXXXX
