# type: haunted
# warp: 74,11 -> 106,13
# warp: 75,11 -> 106,13
# warp: 124,11 -> 77,13
# warp: 125,11 -> 77,13
................................................................................................................................
........................................................................................................XXXXXXXXXXXXXXXXXXXXXXXX
........................................................................................................X......................X
........................................................................................................X......................X
........................................................................................................X..CCCCCCCCCCCCCCCC....X
........................................................................................................X......................X
........................................................................................................X..CCCCCCCCCCCCCCCC....X
..................O.........................O...........................................................X...............O......X
....................................................................................F...................X.........=====........X
..........M.........................M...................................................................X......................X
..............................====........................====..........................................X......................X
..........................................................................TT............................X..CCCCCCCCCCCCCCCC.TT.X
..P.............................................................G.........tt............................X.....O.............tt.X
XXXXXXXXXXXXXXXXXXXXXXXX..XXXXXXXXXXXXXXXXXXXXXXXX...XXXXXXXXXXXXXXXXX..XXXXXXXXXXXXXXXX................XXXXXXXXXXXXXXXXXXXXXXXX
XXXXXXXXXXXXXXXXXXXXXXXX..XXXXXXXXXXXXXXXXXXXXXXXX...XXXXXXXXXXXXXXXXX..XXXXXXXXXXXXXXXX................XXXXXXXXXXXXXXXXXXXXXXXX
