# type: keep
# warp: 75,11 -> 106,13
# warp: 76,11 -> 106,13
# warp: 124,11 -> 78,13
# warp: 125,11 -> 78,13
................................................................................................................................
........................................................................................................XXXXXXXXXXXXXXXXXXXXXXXX
........................................................................................................X......................X
........................................................................................................X......................X
........................................................................................................X..CCCCCCCCCCCCCCCC....X
........................................................................................................X......................X
........................................................................................................X..CCCCCCCCCCCCCCCC....X
........................................................................................................X...............K......X
....................................................................................F...................X.........=====........X
........M.............................M.................................................................X......................X
........................................................................................................X......................X
...................N....................N.....................N............TT...........................X..CCCCCCCCCCCCCCCC.TT.X
..P.........K......N....................N...........K.........N.........K..tt...........................X.....K.............tt.X
XXXXXXXXXXXXXXLLXXXXXX...XXXXXXXXXLLXXXXXXXXXX..XXXXXXXXLLXXXXXXXX...XXXXXXXXXXXXXXXXXXX................XXXXXXXXXXXXXXXXXXXXXXXX
XXXXXXXXXXXXXXLLXXXXXX...XXXXXXXXXLLXXXXXXXXXX..XXXXXXXXLLXXXXXXXX...XXXXXXXXXXXXXXXXXXX................XXXXXXXXXXXXXXXXXXXXXXXX
