# type: ice
# warp: 5,11 -> 106,13
# warp: 6,11 -> 106,13
# warp: 124,11 -> 8,13
# warp: 125,11 -> 8,13
................................................................................................................................
........................................................................................................XXXXXXXXXXXXXXXXXXXXXXXX
........................................................................................................X......................X
........................................................................................................X......................X
........................................................................................................X..CCCCCCCCCCCCCCCC....X
........................................................................................................X......................X
........................................................................................................X..CCCCCCCCCCCCCCCC....X
........................................................................................................X...............I......X
....................................................................................F...................X.........=====........X
..........M.........................M...................................................................X......................X
..............................====........................====..........................................X......................X
.....TT.................................................................................................X..CCCCCCCCCCCCCCCC.TT.X
..P..tt.........I.......................I.......................G.......................................X.....I.............tt.X
XXXXXXXXXXXXXXXXXXXXXXXX..XXXXXXXXXXXXXXXXXXXXXXXX...XXXXXXXXXXXXXXXXX..XXXXXXXXXXXXXXXX................XXXXXXXXXXXXXXXXXXXXXXXX
XXXXXXXXXXXXXXXXXXXXXXXX..XXXXXXXXXXXXXXXXXXXXXXXX...XXXXXXXXXXXXXXXXX..XXXXXXXXXXXXXXXX................XXXXXXXXXXXXXXXXXXXXXXXX
