# type: underground
........................................................................................
XXXXXXXXXXXXXXXXXXXXXXXXXXXXXXXXXXXXXXXXXXXXXXXXXXXXXXXXXXXXXXXXXXXXXXXXXXXXXXXXXXXXXXXX
........................................................................................
........................................................................................
........................................................................................
........................................................................................
........................................................Y...............................
........................................................................................
..................................................................................F.....
..................B?B..............G........................CCCC........................
..................................====......................====........................
........................................................................................
..P......CCCK.G.............................G.....................................K.....
XXXXXXXXXXXXXXXXXXXXXXXX...XXXXXXXXXXXXXXXXXXXXXXX...XXXXXXXXXXXXXXXXXXXXXXXXXXXXXXXXXXX
XXXXXXXXXXXXXXXXXXXXXXXX...XXXXXXXXXXXXXXXXXXXXXXX...XXXXXXXXXXXXXXXXXXXXXXXXXXXXXXXXXXX
