# type: ice
........................................................................................
........................................................................................
........................................................................................
........................................................................................
........................................................................................
........................................................................................
........................................................................................
........................................................................................
....................................................................................F...
......M.....................M.......................M...................................
........................===.............===.............===.............................
........................................................................................
..P.........I.........................I.....G...........I...............I...............
XXXXXXXXXXXXXXXXXX..XXXXXXXXXXXX...XXXXXXXXXXXXX..XXXXXXXXXXXX...XXXXXXXXXXX..XXXXXXXXXX
XXXXXXXXXXXXXXXXXX..XXXXXXXXXXXX...XXXXXXXXXXXXX..XXXXXXXXXXXX...XXXXXXXXXXX..XXXXXXXXXX
