# type: overworld
# warp: 72,11 -> 92,13
# warp: 73,11 -> 92,13
# warp: 104,11 -> 75,13
# warp: 105,11 -> 75,13
............................................................................................................
............................................................................................................
............................................................................................................
............................................................................................................
............................................................................................................
............................................................................................................
............................................................................................................
........................................Y.............................Y...................XXXXXXXXXXXXXXXXXX
..................................................................................F.......X................X
....................?....G..................CCCC.................G........................X................X
........................====................====................====......................X..CCCCCCCCCC....X
........................................................................TT................X..CCCCCCCCCC.TT.X
..P....KCCCCG...................................G.......................tt........K.......X..CCCCCCCCCC.tt.X
XXXXXXXXXXXXXXXX...XXXXXXXXXXXXXX...XXXXXXXXXXXXXXXXXXX...XXXXXXXXXXXXXXXXXXXXXXXXXXXXXX..XXXXXXXXXXXXXXXXXX
XXXXXXXXXXXXXXXX...XXXXXXXXXXXXXX...XXXXXXXXXXXXXXXXXXX...XXXXXXXXXXXXXXXXXXXXXXXXXXXXXX..XXXXXXXXXXXXXXXXXX
