# type: sky
# warp: 4,11 -> 106,13
# warp: 5,11 -> 106,13
# warp: 124,11 -> 7,13
# warp: 125,11 -> 7,13
................................................................................................................................
........................................................................................................XXXXXXXXXXXXXXXXXXXXXXXX
........................................................................................................X......................X
........................................................................................................X......................X
........................................................................................................X..CCCCCCCCCCCCCCCC....X
........................................................................................................X......................X
..........................................Y.............................................................X..CCCCCCCCCCCCCCCC....X
........................................................................................................X...............Y......X
....................................................................................F...................X.........=====........X
......................B?MB....G...............CCCCC.....................................................X......................X
............................=====.............=====.....................................................X......................X
....TT..................................................................................................X..CCCCCCCCCCCCCCCC.TT.X
..P.tt.KCCCCG.......................................G.............G...............K.....................X.....Y.............tt.X
XXXXXXXXXXXXXXXXX...XXXXXXXXXXXXXXXXX...XXXXXXXXXXXXXXXXXX...XXXXXXXXXXX...XXXXXXXXXXXXX................XXXXXXXXXXXXXXXXXXXXXXXX
XXXXXXXXXXXXXXXXX...XXXXXXXXXXXXXXXXX...XXXXXXXXXXXXXXXXXX...XXXXXXXXXXX...XXXXXXXXXXXXX................XXXXXXXXXXXXXXXXXXXXXXXX
