# type: ice
# warp: 5,11 -> 92,13
# warp: 6,11 -> 92,13
# warp: 104,11 -> 8,13
# warp: 105,11 -> 8,13
............................................................................................................
............................................................................................................
............................................................................................................
............................................................................................................
............................................................................................................
............................................................................................................
............................................................................................................
..........................................................................................XXXXXXXXXXXXXXXXXX
....................................................................................F.....X................X
..........M.........................M.....................................................X................X
..............................====........................====............................X..CCCCCCCCCC....X
.....TT...................................................................................X..CCCCCCCCCC.TT.X
..P..tt.........I.......................I.......................G.........................X..CCCCCCCCCC.tt.X
XXXXXXXXXXXXXXXXXXXXXXXX..XXXXXXXXXXXXXXXXXXXXXXXX...XXXXXXXXXXXXXXXXX..XXXXXXXXXXXXXXXX..XXXXXXXXXXXXXXXXXX
XXXXXXXXXXXXXXXXXXXXXXXX..XXXXXXXXXXXXXXXXXXXXXXXX...XXXXXXXXXXXXXXXXX..XXXXXXXXXXXXXXXX..XXXXXXXXXXXXXXXXXX
