# type: caldera
# warp: 4,10 -> 92,12
# warp: 5,10 -> 92,12
# warp: 104,10 -> 7,12
# warp: 105,10 -> 7,12
............................................................................................................
............................................................................................................
............................................................................................................
............................................................................................................
............................................................................................................
............................................................................................................
..................................................................................F.......XXXXXXXXXXXXXXXXXX
..............................................................................=======.....X................X
....................................=====.........=====.........=====..=====..............X................X
......................=====..=====.........=====.........=====............................X..CCCCCCCCCC....X
....TT.........=====......................................................................X..CCCCCCCCCC.TT.X
..P.tt..=====.............................................................................X..CCCCCCCCCC.tt.X
XXXXXXXX..................................................................................XXXXXXXXXXXXXXXXXX
XXXXXXXX..................................................................................XXXXXXXXXXXXXXXXXX
XXXXXXXX....................................................................................................
