# type: underground
........................................................................................
XXXXXXXXXXXXXXXXXXXXXXXXXXXXXXXXXXXXXXXXXXXXXXXXXXXXXXXXXXXXXXXXXXXXXXXXXXXXXXXXXXXXXXXX
........................................................................................
........................................................................................
........................................................................................
........................................................................................
..............................................Y.........................................
........................................................................................
..................................................................................F.....
..........................?M..........................................CCCC..............
......................................................................====..............
........................................................................................
..P...............................G.................G...................................
XXXXXXXXXXXXXXXXXXX...XXXXXXXXXXXXXXXX...XXXXXXXXXXXXXXXXXXXXX...XXXXXXXXXXXXXXXXXXXXXXX
XXXXXXXXXXXXXXXXXXX...XXXXXXXXXXXXXXXX...XXXXXXXXXXXXXXXXXXXXX...XXXXXXXXXXXXXXXXXXXXXXX
