# type: water
# warp: 74,11 -> 106,13
# warp: 75,11 -> 106,13
# warp: 124,11 -> 77,13
# warp: 125,11 -> 77,13
XXXXXXXXXXXXXXXXXXXXXXXXXXXXXXXXXXXXXXXXXXXXXXXXXXXXXXXXXXXXXXXXXXXXXXXXXXXXXXXXXXXXXXXX........................................
........................................................................................................XXXXXXXXXXXXXXXXXXXXXXXX
........................................................................................................X......................X
........................................................................................................X......................X
................H.....................................................H.................................X..CCCCCCCCCCCCCCCC....X
........................................................................................................X......................X
....................................................................................F...................X..CCCCCCCCCCCCCCCC....X
............................................X...........................................................X...............H......X
............................................X...........................................................X.........=====........X
............................................X...........................................................X......................X
..........................X.......H.........X.......H.........X.........................................X......................X
..P.......................X.................X.................X...........TT............................X..CCCCCCCCCCCCCCCC.TT.X
..........................X.................X.................X...........tt............................X.....H.............tt.X
XXXXXXXXXXXXXXXXXXXXXXXXXXXXXXXXXXXXXXXXXXXXXXXXXXXXXXXXXXXXXXXXXXXXXXXXXXXXXXXXXXXXXXXX................XXXXXXXXXXXXXXXXXXXXXXXX
XXXXXXXXXXXXXXXXXXXXXXXXXXXXXXXXXXXXXXXXXXXXXXXXXXXXXXXXXXXXXXXXXXXXXXXXXXXXXXXXXXXXXXXX................XXXXXXXXXXXXXXXXXXXXXXXX
