........................................................................................
........................................................................................
........................................................................................
........................................................................................
........................................................................................
........................................................................................
........................................Y...............................................
..................................................................Y.....................
..................................................................................F.....
......................B?MB.....CCCCC..................CCCCC.............................
...............................=====..................=====.............................
........................................................................................
..P.....CCCCC...............G.....................G...........................G.........
XXXXXXXXXXXXXXXXX...XXXXXXXXXXXXXXXXX...XXXXXXXXXXXXXXXXXXXXXX...XXXXXXXXXXXXXXXXXXXXXXX
XXXXXXXXXXXXXXXXX...XXXXXXXXXXXXXXXXX...XXXXXXXXXXXXXXXXXXXXXX...XXXXXXXXXXXXXXXXXXXXXXX
