# type: haunted
........................................................................................
........................................................................................
........................................................................................
........................................................................................
........................................................................................
........................................................................................
......................................O.................................................
..............O.......................................................O.................
......................................................O.............................F...
......M.....................M.......................M...................................
........................===.............===.............===.............................
........................................................................................
..P.........................................G...........................................
XXXXXXXXXXXXXXXXXX..XXXXXXXXXXXX...XXXXXXXXXXXXX..XXXXXXXXXXXX...XXXXXXXXXXX..XXXXXXXXXX
XXXXXXXXXXXXXXXXXX..XXXXXXXXXXXX...XXXXXXXXXXXXX..XXXXXXXXXXXX...XXXXXXXXXXX..XXXXXXXXXX
