# type: overworld
# warp: 5,11 -> 92,13
# warp: 6,11 -> 92,13
# warp: 104,11 -> 8,13
# warp: 105,11 -> 8,13
............................................................................................................
............................................................................................................
............................................................................................................
............................................................................................................
............................................................................................................
............................................................................................................
....................................................Y.......................................................
..........................................................................................XXXXXXXXXXXXXXXXXX
..................................................................................F.......X................X
........................B?MB...G................................CCCC......................X................X
..............................====..............................====......................X..CCCCCCCCCC....X
.....TT...................................................................................X..CCCCCCCCCC.TT.X
..P..tt.CCCCK.G.......................G.....................G.....................K.......X..CCCCCCCCCC.tt.X
XXXXXXXXXXXXXXXXXXXX...XXXXXXXXXXXXXXXXXXXXXX...XXXXXXXXXXXXXXXXXXXXXXXXXXXXXXXXXXXXXXXX..XXXXXXXXXXXXXXXXXX
XXXXXXXXXXXXXXXXXXXX...XXXXXXXXXXXXXXXXXXXXXX...XXXXXXXXXXXXXXXXXXXXXXXXXXXXXXXXXXXXXXXX..XXXXXXXXXXXXXXXXXX
