# type: underground
# warp: 40,11 -> 96,13
# warp: 41,11 -> 96,13
# warp: 111,11 -> 46,13
# warp: 112,11 -> 46,13
....................................................................................................................
XXXXXXXXXXXXXXXXXXXXXXXXXXXXXXXXXXXXXXXXXXXXXXXXXXXXXXXXXXXXXXXXXXXXXXXXXXXXXXXXXXXXXXXX............................
....................................................................................................................
....................................................................................................................
....................................................................................................................
....................................................................................................................
........................................................Y...........................................................
....................................................................................................................
..................................................................................F.................................
..................B?B..............G........................CCCC...............................XXXXXXXXXXXXXXXXXXXX.
..................................====......................====...............................X..CCCCCCCCCCCC....X.
........................................TT.....................................................X..CCCCCCCCCCCC.TT.X.
..P......CCCK.G.........................tt..G.....................................K............X..CCCCCCCCCCCC.tt.X.
XXXXXXXXXXXXXXXXXXXXXXXX...XXXXXXXXXXXXXXXXXXXXXXX...XXXXXXXXXXXXXXXXXXXXXXXXXXXXXXXXXXX.......XXXXXXXXXXXXXXXXXXXX.
XXXXXXXXXXXXXXXXXXXXXXXX...XXXXXXXXXXXXXXXXXXXXXXX...XXXXXXXXXXXXXXXXXXXXXXXXXXXXXXXXXXX.......XXXXXXXXXXXXXXXXXXXX.
