# type: underground
........................................................................................
XXXXXXXXXXXXXXXXXXXXXXXXXXXXXXXXXXXXXXXXXXXXXXXXXXXXXXXXXXXXXXXXXXXXXXXXXXXXXXXXXXXXXXXX
........................................................................................
........................................................................................
........................................................................................
........................................................................................
..............................................Y.........................................
........................................................................................
..................................................................................F.....
..........................?M.G........................................CCCC..............
............................====......................................====..............
........................................................................................
..P......K..G.....................G.................G.............................K.....
XXXXXXXXXXXXXXXXXXX...XXXXXXXXXXXXXXXX...XXXXXXXXXXXXXXXXXXXXX...XXXXXXXXXXXXXXXXXXXXXXX
XXXXXXXXXXXXXXXXXXX...XXXXXXXXXXXXXXXX...XXXXXXXXXXXXXXXXXXXXX...XXXXXXXXXXXXXXXXXXXXXXX
