# type: factory
# warp: 4,11 -> 106,13
# warp: 5,11 -> 106,13
# warp: 124,11 -> 7,13
# warp: 125,11 -> 7,13
................................................................................................................................
........................................................................................................XXXXXXXXXXXXXXXXXXXXXXXX
........................................................................................................X......................X
........................................................................................................X......................X
........................................................................................................X..CCCCCCCCCCCCCCCC....X
........................................................................................................X......................X
........................................................................................................X..CCCCCCCCCCCCCCCC....X
........................................................................................................X...............R......X
....................................................................................F...................X.........=====........X
........M...............................M...............................................................X......................X
..................===.........................===.......................................................X......................X
....TT..................................................................................................X..CCCCCCCCCCCCCCCC.TT.X
..P.tt....................R.................................R...........G...............................X.....R.............tt.X
XXXXXXXXXX>>>>>>>XXXXX..XXXXXX<<<<<<<XXXXXXX..XXXX>>>>>>>XXXXXXX...XXXXXXXXXXXXXXXXXXXXX................XXXXXXXXXXXXXXXXXXXXXXXX
XXXXXXXXXXXXXXXXXXXXXX..XXXXXXXXXXXXXXXXXXXX..XXXXXXXXXXXXXXXXXX...XXXXXXXXXXXXXXXXXXXXX................XXXXXXXXXXXXXXXXXXXXXXXX
