# type: overworld
........................................................................................
........................................................................................
........................................................................................
........................................................................................
........................................................................................
........................................................................................
........................................Y...............................................
................................................................Y.......................
....................................................................................F...
......................B?MB.....CCCCC....................................................
...............................=====....................................................
........................................................................................
..P.....CCCCC.................G.................G.................G.....................
XXXXXXXXXXXXXXXXX...XXXXXXXXXXXXXXXXX...XXXXXXXXXXXXXXXXXX...XXXXXXXXXXX...XXXXXXXXXXXXX
XXXXXXXXXXXXXXXXX...XXXXXXXXXXXXXXXXX...XXXXXXXXXXXXXXXXXX...XXXXXXXXXXX...XXXXXXXXXXXXX
