# type: keep
# warp: 4,11 -> 92,13
# warp: 5,11 -> 92,13
# warp: 104,11 -> 7,13
# warp: 105,11 -> 7,13
............................................................................................................
............................................................................................................
............................................................................................................
............................................................................................................
............................................................................................................
............................................................................................................
............................................................................................................
..........................................................................................XXXXXXXXXXXXXXXXXX
....................................................................................F.....X................X
........M...........................M.....................................................X................X
........................====....................................====......................X..CCCCCCCCCC....X
....TT........................N.....................N.....................................X..CCCCCCCCCC.TT.X
..P.tt........K...............N.................K...N.................K...................X..CCCCCCCCCC.tt.X
XXXXXXXXXXXXXXXXXXXXLLXXXXXXXXXXXXXXXXXX...XXXXXXXXXXXXXXXXXLLXXXXXXXXXXXXXXXXXXXXXXXXXX..XXXXXXXXXXXXXXXXXX
XXXXXXXXXXXXXXXXXXXXLLXXXXXXXXXXXXXXXXXX...XXXXXXXXXXXXXXXXXLLXXXXXXXXXXXXXXXXXXXXXXXXXX..XXXXXXXXXXXXXXXXXX
