# type: sky
# warp: 74,11 -> 92,13
# warp: 75,11 -> 92,13
# warp: 104,11 -> 77,13
# warp: 105,11 -> 77,13
............................................................................................................
............................................................................................................
............................................................................................................
............................................................................................................
............................................................................................................
............................................................................................................
............................................................................................................
..........................................................................................XXXXXXXXXXXXXXXXXX
....................................................................................F.....X................X
..........................M...............................................................X................X
..............................====....................====................................X..CCCCCCCCCC....X
......................................N.....................N.............TT..............X..CCCCCCCCCC.TT.X
..P...........G.......................N...........K.........N...........G.tt..............X..CCCCCCCCCC.tt.X
XXXXXXXXXXXXXXXXXXXX...XXXXXXXXXXXXXXXXXXXXX..XXXXXXXXXXXXXXXXXXXX...XXXXXXXXXXXXXXXXXXX..XXXXXXXXXXXXXXXXXX
XXXXXXXXXXXXXXXXXXXX...XXXXXXXXXXXXXXXXXXXXX..XXXXXXXXXXXXXXXXXXXX...XXXXXXXXXXXXXXXXXXX..XXXXXXXXXXXXXXXXXX
