# type: sky
........................................................................................
........................................................................................
........................................................................................
........................................................................................
........................................................................................
........................................................................................
........................................................................................
........................................................................................
....................................................................................F...
........M...............................................................................
....................===...............===...............===.............................
........................N...................N...............N...........................
..P.........K...........N...........G.......N...............N.........K.................
XXXXXXXXXXXXXXXX..XXXXXXXXXXXX...XXXXXXXXXXXXXXXXX..XXXXXXXXXXXX...XXXXXXXXXXXXXXXXXXXXX
XXXXXXXXXXXXXXXX..XXXXXXXXXXXX...XXXXXXXXXXXXXXXXX..XXXXXXXXXXXX...XXXXXXXXXXXXXXXXXXXXX
