# type: ice
........................................................................................
........................................................................................
........................................................................................
........................................................................................
........................................................................................
........................................................................................
........................................................................................
........................................................................................
....................................................................................F...
........M.......................M.......................................................
..........................====..............====............===.........................
........................................................................................
..P...........I...........K.....................I...............I.......................
XXXXXXXXXXXXXXXXXXXX..XXXXXXXXXXXXXX...XXXXXXXXXXXXXXX..XXXXXXXXXXXX...XXXXXXXXXXXXXXXXX
XXXXXXXXXXXXXXXXXXXX..XXXXXXXXXXXXXX...XXXXXXXXXXXXXXX..XXXXXXXXXXXX...XXXXXXXXXXXXXXXXX
