# type: factory
# warp: 4,11 -> 92,13
# warp: 5,11 -> 92,13
# warp: 104,11 -> 7,13
# warp: 105,11 -> 7,13
............................................................................................................
............................................................................................................
............................................................................................................
............................................................................................................
............................................................................................................
............................................................................................................
............................................................................................................
..........................................................................................XXXXXXXXXXXXXXXXXX
....................................................................................F.....X................X
........M...............................M.................................................X................X
..................===.........................===.........................................X..CCCCCCCCCC....X
....TT....................................................................................X..CCCCCCCCCC.TT.X
..P.tt....................R.................................R...........G.................X..CCCCCCCCCC.tt.X
XXXXXXXXXX>>>>>>>XXXXX..XXXXXX<<<<<<<XXXXXXX..XXXX>>>>>>>XXXXXXX...XXXXXXXXXXXXXXXXXXXXX..XXXXXXXXXXXXXXXXXX
XXXXXXXXXXXXXXXXXXXXXX..XXXXXXXXXXXXXXXXXXXX..XXXXXXXXXXXXXXXXXX...XXXXXXXXXXXXXXXXXXXXX..XXXXXXXXXXXXXXXXXX
