# type: water
XXXXXXXXXXXXXXXXXXXXXXXXXXXXXXXXXXXXXXXXXXXXXXXXXXXXXXXXXXXXXXXXXXXXXXXXXXXXXXXXXXXXXXXX
........................................................................................
........................................................................................
........................................................................................
....................H...............................................H...................
........................................................................................
....................................................................................F...
........................................................................................
......................................CCCCC.............................................
........................................................................................
..............................X.............H...........X...............................
..P...........................X.........................X...............................
..............................X.........................X...............................
XXXXXXXXXXXXXXXXXXXXXXXXXXXXXXXXXXXXXXXXXXXXXXXXXXXXXXXXXXXXXXXXXXXXXXXXXXXXXXXXXXXXXXXX
XXXXXXXXXXXXXXXXXXXXXXXXXXXXXXXXXXXXXXXXXXXXXXXXXXXXXXXXXXXXXXXXXXXXXXXXXXXXXXXXXXXXXXXX
