# type: castle_keep
........................................................................................
XXXXXXXXXXXXXXXXXXXXXXXXXXXXXXXXXXXXXXXXXXXXXXXXXXXXXXXXXXXXXXXXXXXXXXXXXXXXXXXXXXXXXXXX
......................................................................................XX
......................................................................................XX
......................................................................................XX
......................................................................................XX
......................................................................................XX
......................................................................................XX
......................................................................................XX
......................................................................................XX
........................M...M...................M.......M.......M.....................XX
............................................................N...................N.....XX
..P.........................................................N...........Z.......N.....XX
XXXXXXXXXXXXXXXXXLLXXXXXXXXXXXXXXXXXXXXXLLXXXXXXXXXXXXXXXXXXXXXXXXXXXXXXXXXXXXXXXXXXXXXX
XXXXXXXXXXXXXXXXXLLXXXXXXXXXXXXXXXXXXXXXLLXXXXXXXXXXXXXXXXXXXXXXXXXXXXXXXXXXXXXXXXXXXXXX
