# type: sky
# warp: 4,11 -> 92,13
# warp: 5,11 -> 92,13
# warp: 104,11 -> 7,13
# warp: 105,11 -> 7,13
............................................................................................................
............................................................................................................
............................................................................................................
............................................................................................................
............................................................................................................
............................................................................................................
..........................................Y.................................................................
..........................................................................................XXXXXXXXXXXXXXXXXX
....................................................................................F.....X................X
......................B?MB....G...............CCCCC.......................................X................X
............................=====.............=====.......................................X..CCCCCCCCCC....X
....TT....................................................................................X..CCCCCCCCCC.TT.X
..P.tt.KCCCCG.......................................G.............G...............K.......X..CCCCCCCCCC.tt.X
XXXXXXXXXXXXXXXXX...XXXXXXXXXXXXXXXXX...XXXXXXXXXXXXXXXXXX...XXXXXXXXXXX...XXXXXXXXXXXXX..XXXXXXXXXXXXXXXXXX
XXXXXXXXXXXXXXXXX...XXXXXXXXXXXXXXXXX...XXXXXXXXXXXXXXXXXX...XXXXXXXXXXX...XXXXXXXXXXXXX..XXXXXXXXXXXXXXXXXX
