# type: water
# warp: 74,11 -> 92,13
# warp: 75,11 -> 92,13
# warp: 104,11 -> 77,13
# warp: 105,11 -> 77,13
XXXXXXXXXXXXXXXXXXXXXXXXXXXXXXXXXXXXXXXXXXXXXXXXXXXXXXXXXXXXXXXXXXXXXXXXXXXXXXXXXXXXXXXX....................
............................................................................................................
............................................................................................................
............................................................................................................
................H.....................................................H.....................................
............................................................................................................
....................................................................................F.......................
............................................X.............................................XXXXXXXXXXXXXXXXXX
............................................X.............................................X................X
............................................X.............................................X................X
..........................X.......H.........X.......H.........X...........................X..CCCCCCCCCC....X
..P.......................X.................X.................X...........TT..............X..CCCCCCCCCC.TT.X
..........................X.................X.................X...........tt..............X..CCCCCCCCCC.tt.X
XXXXXXXXXXXXXXXXXXXXXXXXXXXXXXXXXXXXXXXXXXXXXXXXXXXXXXXXXXXXXXXXXXXXXXXXXXXXXXXXXXXXXXXX..XXXXXXXXXXXXXXXXXX
XXXXXXXXXXXXXXXXXXXXXXXXXXXXXXXXXXXXXXXXXXXXXXXXXXXXXXXXXXXXXXXXXXXXXXXXXXXXXXXXXXXXXXXX..XXXXXXXXXXXXXXXXXX
